#########
#       #
#E##### #
###   # #
#   #   #
# #######
#       S
#########
